wwwwwwwwwwww
w.......c..w
w...1......w
w..p1......w
w...1......w
w...1......w
w.......1..w
w..........w
w..........w
w..2......ew
w..........w
wwwwwwwwwwww


wwwwwwwwwwww
w..e.......w
w..........w
w......1...w
w..........w
w...p......w
w..........w
w.....1....w
w..........w
w..1.......w
w..........w
wwwwwwwwwwww


wwwwwwwwwwww
w..........w
w..........w
w.c....1...w
w..........w
w...p.2....w
w..........w
w.....1....w
w..........w
w..1.......w
w....e.....w
wwwwwwwwwwww
